15 20
....................
.###..........###...
.###..XXXX....###...
S....XXXX...........
.....XXXX...........
...................$
....................
.....###............
.....###....XXXX....
............XXXX....
......$....XXXX.....
....................
.............###....
.............###..D.
....................
