12 20
S...................
.###.###.###.###.###
.......................
###.###.###.###.###.
.......................
.###.###.###.###.###
.......................
###.###.###.###.###.
....................$...
.###.###.###.###.###
...................D
####################
