10 15
...............
.###...###.....
.###...###.....
S..............
...............
.....###.......
.....###.......
..............D
...............
...............
